R  1920 1080
NO assets/asd.xpm
SO assets/muroHD.xpm
EA assets/rockx256.xpm
WE assets/sp.xpm
S assets/pippo.xpm

F 220,100,35
C 225,30,16

           11111111111111111
           100002000000000011
           100000000000200001
11111111111100001111111111111
10200000200000001
1000000000000001111111
11100000000000200000001
11011111000N000011111111
111100002000000001
1111111111011100001111
10000000000000001111111
10000000000020001
11111011111111111
1111101111
1000000001
100001111
1111111