11111111111111111
10000200000000001
10000000000020001
10000100100100001
10200000200000001
10000000000000001
10000000N00020001
10002000000000001
10000002000000001
10000000020000001
10000000000000001
10000000000020001
111111211111111111