R  1920 1080
NO ./textures/wood.xpm
SO ./textures/eagle.xpm
EA ./textures/rockx256.xpm
WE ./textures/graystone.xpm

S ./textures/zombiex64.xpm
F 220,100,35
C 225,30,16

           11111111111111111
           10000200000000001
           10000000000020001
1111111111110000111111111111
10200000200000001
10000000000000001
1110000000S000201111111111111
  100020000000000000000000001
11100002000000001111111111111
10000000020000001
10000000000000001
10000000000020001
11111111111111111